111111111111111111111111111

11111111PCE1111111101111111
111111111111111111111111111
