11111111111111111111111111111111111
100000000000000000000000000000000E1
100000000000000000000000000000000C1
10000000000000000000000000000000001
10000000000000000000000000000000P111
11111111111111111111111111111111111
